1111111111111
10000000000001
1111111111111
