1111111111111
1000000000001
1C00E00C00001
1000000000001
100P010010001
100001C010001
100C010010001
1111111111111
