1111111111111
1000000000001
1000000000001
1000000000001
100P010010001
1000010010001
1000010010001
1111111111111
