11111111
1000P001
1000EC01
11111111