111111
1000P1
100E01
1C0001
111111